00000000000000000
31110000000000000
00040000000000000
00010000000000000
00050000011510000
00014111410040000
00000000000010000
00000000000011110
00000000000000040
00000000000000010
00000000000000011
